00 01 03 01 02 01 00 01 00 01 00 01 00 01  
00 01 03 01 04 01 00 01 00 01 00 01 00 01  
00 01 03 01 02 01 00 01 00 01 00 01 00 01  
00 01 03 01 00 01 00 01 00 01 00 01 00 01  
00 01 03 01 00 01 00 01 00 01 00 01 00 01  
